11111111111
11000000011
1000C1C0001
1P0111110E1
1000C100001
11000000011
11111111111