1111111111
1P00000C01
1000C000E1
1111111111