1111111111
1P00000001
100010C001
100C010001
10000000E1
1111111111