1111111111111
1P000C10000C1
1001111001111
1001C00000001
1001001111101
1C00001E00001
1111111111111