111111111111111111111111111111
111P000C10000C110000C10000C111
111001111001111100111100111111
111001C000000011001C0000000111
111001001111101100100111110111
111C00001C000000000001C0000111
11111101111000111110111101C111
111110111110001110111111111111
111C000C10000C110000C10000C111
111001111001111100111100111111
111001C000000011001C0000000111
111001001111101100100111110111
111C00001C000000000001E0000111
111111111111111111111111111111