1111111111
1P000010E1
1000101001
1CCC010001
11CCCC0011
1111111111