11111
1P001
10001
10C01
10001
100E1
11111